:composition:4
<手臂姿势>
手臂在头后=arms behind head
手臂在背后=arms behind back

伸直双臂=outstretched arms
伸出单臂=outstretched arm

伸出手=outstretched hand

双手垂放=arms at sides

单抬臂=arm up
双抬臂=arms up



张手=spread arms

用手支撑住=arm support
手交叉于胸前=arms crossed
交叉双臂=crossed arms
托胸=arm under breasts
双手托胸=arms under breasts

手臂后拉=arm held back
遮住关键部位的手臂=convenient arm

手臂摆出心姿势=heart arms

<手指姿势>

翘大拇指=thumbs up


食指抬起=index finger raised
猫爪=cat pose
指枪=finger gun
虎爪=claw pose
爪子=paw pose
狐狸手势=fox shadow puppet

V手势=peace hand
胜利手势=victory pose
v在嘴上=v over mouth



九字印=kuji-in

嘘手势=shushing

伸小拇指=pinky out

指尖抵指间=steepled fingers
比中指=middle finger

握拳=fist
攥拳=clenched hand
攥拳=clenched hands

举起拳头=raised fist

紧张手势=fidgeting

舔手指=finger to mouth

双手相扣=own hands clasped
双手相合=own hands together

张开双手=open hands
张开手=open hand


双手比心=heart hands


手杯=cupping hands

爽手势=shocker



用手指比数字=finger counting

兰花指=orchid fingers

<手位置>
手在头发里=hand in hair
手放嘴上=hand to own mouth
手放脸上=hand on own face
双手放脸=hands on own face
手放帽子上=hand on headwear
手放自己头上=hand on own head
手放耳朵=hand on ear
手放前额=hand on own forehead
手放下颚=hand on own chin
手放脸颊=hand on own cheek

手放脖子=hand on own neck
手放肩上=hand on own shoulder
手放胸部=hand on own chest
手放肚子=hand on own stomach
手放臀部=hand on own ass
双手放臀部=hands on ass
手放膝盖=hand on own knee
双手放膝盖=hands on own knees
手在大腿间=hand between legs
双手放脚=hands on feet
手插兜=hands in pocket
手插兜=hand in pocket
双手插兜=hands in pockets
手在内裤里=hand in panties
单手叉腰=hand on hip
双手叉腰=hands on hips

<头发互动>

拨头发=hand in own hair
拨头发=hair flip
拉头发=hair pull

撩头发=adjusting hair
撩头发=hair tucking
札头发=tying hair
梳头=hairdressing //建议加个梳子
卷头发=hair twirling
扎辫子=bunching hair

<衣服互动>
捏着帽檐=hat tip
提裙=skirt lift
提裙=skirt hold
拉起自己衣服=lifted by self
拉起衣服=clothes lift
拉起连衣裙=dress lift
拉下连衣裙下摆=dress tug
胸罩拉到胸上方=bra lift
拉着吊带=holding strap
整理裤袜=adjusting legwear
抓着领带=necktie grab
拨内裤=adjusting panties
拉起和服=kimono lift

<其他互动>

抱着枕头=pillow hug
抱着某物=object hug




揉眼睛=rubbing eyes
遮住耳朵=covering ears

抱自己腿=hugging own legs
捏着肚子=belly grab

搅拌=stir //偏弱
搅拌=whisking //很强

投掷=pitching
带着=carrying
拿着长枪=polearm

扶眼镜=adjusting eyewear

伸手触及=reaching


打结=tying



<指向>

指向=pointing
指向观众=pointing at viewer
指向上=pointing up
指向下=pointing down
指向前=pointing forward

<其他姿势>

展示腋下=presenting armpit
展示内裤=presenting panties

遮着裆部=covering crotch

托腮=chin rest
托颊=head rest



托胸=breast hold

挥手=waving
敬礼=salute
二指敬礼=two-finger salute
瓦肯举手礼=vulcan salute

耸肩-shrugging

拿着=holding



力量拳头=power fist

抱着我手势=carry me
皮影戏=shadow puppet

<双人姿势>
(双人)牵手=holding hands
(双人)手指相扣=interlocked fingers
(双人)扳手腕=arm wrestling
(双人)挽手=arm hug
(双人)抓住手臂=arm grab
(双人)手接触对方的=hand on another's
(双人)手触碰对方的脸=hand on another's face
(双人)双手放对方脸上=hands on another's face
(双人)手托着对方的下巴=hand on another's chin
(双人)手摸着对方的脸颊=hand on another's cheek
(双人)手放对方脖子=hand on another's neck
(双人)手搂着脖子=arm around neck
(双人)双手搂着脖子=arms around neck
(双人)手放在对方头上=hand on another's head
(双人)手放对方肩上=hand on another's shoulder
(双人)手放对方手上=hand on another's hand
(双人)手在对方胸前=hand on another's chest
(双人)双手放在对方胸前=hands on another's breast
(双人)手放对方肚子上=hand on another's stomach
(双人)被对方掀起衣物=lifted by another
(双人)两人一起比心=heart hands duo
(三人)三人用手比心=heart hands trio
(双人)抓起对方头发=grabbing another's hair
(双人)勾指起誓=pinky swear
(双人)轻抚脸颊=stroking on chin
(双人)双拳挤头=noogie
(不限定双人)摸头=headpat //甚至不需要双人
(不限定双人)碰拳=fist bump
(不限定双人)击掌=high five
(不限定双人)手指隔着衣物摸=fingering through clothes
